100
8
23 5 0 0 0 0 0 0 0 0 0 0 0 0 0 0 4 23 23 5 0 0 0 0 0 0 0 0 0 0 0 0 0 0 0 0 0 0 0 0 0 0 0 0 0 0 0 0 0 0 0 0 0 0 0 0 0 0 0 0 0 0 0 0 0 0 0 0 0 0 0 0 0 4 23 23 23 23 5 0 0 0 0 0 0 0 0 0 0 0 0 0 0 0 0 0 0 0 0 0 
23 5 0 0 0 0 0 0 0 0 0 0 0 0 0 0 0 0 0 0 0 0 0 0 0 0 0 0 0 0 0 0 0 0 0 0 0 0 0 0 0 0 0 0 0 0 0 0 0 0 0 0 0 0 0 0 0 0 0 0 0 0 0 0 0 0 0 0 0 0 0 0 0 4 23 23 23 23 5 0 0 0 0 0 0 0 0 0 0 0 0 0 0 0 0 0 0 0 0 0 
23 5 0 0 0 0 0 0 0 0 0 0 0 0 0 0 0 0 0 0 2 22 3 0 0 0 0 0 0 0 0 0 0 0 0 0 0 0 0 0 0 0 0 0 0 0 0 0 0 0 0 0 0 0 0 0 0 0 0 0 0 0 0 0 0 0 0 2 22 22 22 22 22 22 23 23 22 22 22 22 3 2 22 3 0 0 0 0 0 0 0 0 0 0 0 0 0 0 0 0 
23 5 0 0 0 0 0 0 0 0 0 0 0 0 0 0 0 0 0 0 4 23 5 0 0 0 0 0 0 0 0 0 0 0 0 0 0 0 0 0 0 0 0 0 0 0 0 0 0 0 0 0 0 0 0 0 0 0 0 0 0 0 2 22 22 3 0 4 23 23 23 23 23 23 23 23 0 0 0 0 0 4 23 5 0 0 0 0 0 0 0 0 0 0 0 0 0 0 0 0 
23 5 0 0 0 0 0 0 0 0 0 0 0 2 22 22 22 22 3 0 4 23 5 0 0 0 0 0 0 0 0 0 0 0 0 0 0 0 0 0 0 0 0 0 0 0 0 0 0 0 0 0 0 0 0 0 0 0 0 2 22 22 22 6 6 5 0 0 0 0 0 0 0 0 0 0 0 0 0 0 2 22 23 5 0 0 0 0 0 0 0 0 0 0 0 0 0 0 0 0 
23 5 0 0 0 0 0 0 0 0 0 0 0 4 23 23 23 23 5 0 4 23 5 0 0 0 0 0 0 0 0 0 24 25 25 26 0 0 0 0 0 0 0 24 25 26 0 0 0 0 0 0 0 0 0 0 0 0 2 22 22 6 6 6 6 5 0 0 0 0 0 0 0 0 0 0 0 0 0 2 22 23 23 5 0 0 0 0 0 0 0 0 0 0 0 0 0 0 0 0 
23 5 0 0 0 0 0 0 0 0 2 22 3 4 23 23 23 23 5 0 4 23 5 0 0 0 0 0 0 0 0 0 0 0 0 0 0 0 0 0 0 0 0 0 0 0 0 0 0 0 0 0 0 0 2 22 3 0 4 23 23 23 23 23 23 5 0 0 0 0 2 22 3 0 0 0 2 22 3 4 23 23 23 5 0 0 0 0 0 24 22 26 0 0 22 22 22 22 22 22 
22 22 22 22 22 22 22 22 22 22 22 22 22 22 23 23 23 23 5 0 4 23 5 0 0 0 0 0 0 0 0 0 0 0 0 0 0 0 0 0 0 0 0 0 0 0 0 0 0 0 0 0 2 22 22 22 22 22 22 22 22 22 22 22 22 22 3 0 0 2 22 22 22 22 22 22 22 22 22 22 23 23 23 22 3 0 0 0 0 0 6 0 0 0 23 23 23 23 23 23


